{
    "default": [["S", "#", "#", "#"],
                ["#", "@", "@", "#"],
                ["#", "@", "#", "#"],
                ["#", "#", "#", "F"]],

    "maze_01": [["S", "@", "#", "F"],
                ["#", "@", "#", "@"],
                ["#", "@", "#", "#"],
                ["#", "#", "#", "#"]]
}
